1111111111111111
100C0000000C0001
1010111011101101
101000000C000101
1010111111100101
1C00000C00000C01
1010111111100101
10000C000C000101
1101111011101101
1C0CE00000C00P01
1111111111111111