1111111111111111
100C0000000C0001
1010111011101101
101000000C0P0101
1010111011101101
1E000000C0000001
1111111111111111
