1111111111
10P0E00011
1C0C001011
1111111111