1111111111111111
1100011000110001
1111111111111111
1000000000000001
101011101110C101
1000C00000000001
1010111011100101
1000000000000001
10101110111011P1
1000C00E00000001
1111111111111111
