1111111111111111
100C00X0000C0001
1010111011101101
101000000C000101
1010111111100101
1C00000C000X0C01
1010111111100101
10100C0X0C000101
1000101110111011
1CE00000C0000P01
1111111111111111