1111111111111111
10XC0000000C0001
1010111011101101
101000000C00X101
1010111111100101
1C00000C00000C01
1010111111100101
10100C000C000101
1010111011101101
1E000X00C0000P01
1111111111111111
